NO ./texture/ray/no.xpm
SO ./texture/ray/so.xpm
WE ./texture/ray/we.xpm
EA ./texture/ray/ea.xpm

F 220,100,1
C 225,30,0

              11111111111111111111111111111111111111111111111111111111111111111111111
              1E000000000000000000000000000000000000000000000000000000000000000000001
              10000000000000000000000000000000000000000000000000000000000000000000001
              10000000000000000000000000000000000000000000000000000000000000000000001
              10000000000000000000000000000000000000000000000000000000000000000000001
              10000000000000000000000000000000000000000000000000000000000000000000001
              11111111111111111111111111111111111111111111111111111111111111111111111
